filename, language, HTML, comment, blank, total
admin\BW.html, HTML, 147, 2, 10, 159
admin\bookManage.html, HTML, 255, 7, 29, 291
admin\bookTest.html, HTML, 119, 3, 6, 128
edit\editInfo.html, HTML, 327, 2, 16, 345
index.html, HTML, 26, 0, 3, 29
login.html, HTML, 146, 3, 5, 154
reader\BW.html, HTML, 150, 2, 10, 162
reader\bookSearching.html, HTML, 150, 7, 9, 166
reader\index.html, HTML, 38, 2, 7, 47
register.html, HTML, 256, 2, 24, 282
Total, -, 1614, 30, 119, 1763