filename, language, PHP, comment, blank, total
account\login.php, PHP, 38, 0, 7, 45
account\loginState.php, PHP, 41, 6, 3, 50
account\register.php, PHP, 39, 0, 4, 43
books\addBook.php, PHP, 43, 0, 2, 45
books\borrow.php, PHP, 37, 0, 4, 41
books\removeBook.php, PHP, 21, 0, 2, 23
books\return.php, PHP, 57, 5, 6, 68
db.php, PHP, 43, 0, 3, 46
tokenGen.php, PHP, 26, 0, 3, 29
Total, -, 345, 11, 34, 390